###     B#
#   ##   #
# #    ###
# #### ###
# ###   ##
A     ####