#       B#
# # ##   #
# #     ##
# ###### #
# ###   ##
A     ####